clave,nombre,poblacií_n_de_3_aí±os_y_míçs_que_habla_alguna_lengua_indí_gena,p_masculina_3_aí±os_y_míçs_habla_lengua_indí_gena,p_femenina_3_aí±os_míçs_habla_lengua_indí_gena,p_3_aí±os_y_míçs_habla_lengua_indí_gena_no_habla_espaí±ol,p_masculina_3_aí±os_míçs_habla_lengua_indí_gena_no_espaí±ol,p_femenina_3_aí±os_y_míçs_habla_lengua_indí_gena_no_espaí±ol,p_3_aí±os_y_míçs_habla_lengua_indí_gena_habla_espaí±ol,p_masculina_3_aí±os_y_míçs_habla_lengua_indí_gena_habla_espaí±o,p_femenina_3_aí±os_y_míçs_habla_lengua_indí_gena_habla_espaí±ol,poblacií_n_5_aí±os_y_míçs_habla_lengua_indí_gena,p_5_aí±os_míçs_habla_lengua_indí_gena_no_habla_espaí±ol,p_5_aí±os_y_míçs_habla_lengua_indí_gena_habla_espaí±ol,poblacií_n_en_hogares_censales_indí_genas,poblacií_n_de_5_aí±os_y_míçs_que_habla_lengua_indí_gena,p_5_aí±os_y_míçs_habla_lengua_indí_gena_y_espaí±ol,p_5_aí±os_y_míçs_habla_lengua_indí_gena_y_habla_espaí±ol
14,Jalisco,53695,27388,26307,5412,1991,3421,37447,19743,17704,51702,4353,36899,87638,39259,3171,34550
1,Acatic,36,24,12,0,0,0,14,12,2,35,0,14,59,65,0,57
2,Acatlíçn de Juíçrez,504,491,13,0,0,0,484,476,8,503,0,484,71,62,0,54
3,Ahualulco de Mercado,17,11,6,0,0,0,7,5,2,17,0,7,65,86,0,80
4,Amacueca,4,2,2,0,0,0,4,2,2,4,0,4,15,10,0,6
5,Amatitíçn,21,9,12,0,0,0,10,7,3,20,0,10,41,50,0,46
6,Ameca,155,98,57,1,1,0,91,59,32,152,1,90,349,175,0,163
7,San Juanito de Escobedo,26,14,12,0,0,0,11,7,4,25,0,11,39,16,0,12
8,Arandas,248,164,84,2,2,0,121,84,37,240,1,118,506,215,0,185
9,El Arenal,25,13,12,0,0,0,12,7,5,25,0,12,58,30,0,28
10,Atemajac de Brizuela,9,6,3,0,0,0,4,3,1,9,0,4,19,17,0,15
11,Atengo,4,3,1,0,0,0,1,0,1,4,0,1,5,17,0,15
12,Atenguillo,13,9,4,0,0,0,5,4,1,13,0,5,41,12,0,10
13,Atotonilco el Alto,124,65,59,1,0,1,53,31,22,122,1,53,285,85,0,79
14,Atoyac,43,30,13,5,1,4,33,25,8,43,5,33,23,64,3,58
15,Autlíçn de Navarro,592,303,289,5,1,4,463,247,216,575,4,451,932,320,3,295
16,Ayotlíçn,61,32,29,0,0,0,22,13,9,59,0,22,169,124,0,104
17,Ayutla,16,8,8,0,0,0,5,3,2,14,0,5,49,35,0,34
18,La Barca,112,60,52,0,0,0,49,30,19,107,0,49,244,190,0,171
19,Bolaí±os,4040,1971,2069,665,273,392,3319,1673,1646,3777,471,3256,4485,2125,297,1791
20,Cabo Corrientes,22,12,10,0,0,0,10,7,3,21,0,10,50,47,0,44
21,Casimiro Castillo,34,21,13,0,0,0,15,10,5,34,0,15,66,84,0,76
22,Cihuatlíçn,416,226,190,16,5,11,348,192,156,398,12,336,721,254,6,232
23,Zapotlíçn el Grande,218,138,80,0,0,0,132,93,39,214,0,132,496,266,0,257
24,Cocula,32,19,13,0,0,0,17,9,8,29,0,16,59,50,0,48
25,Colotlíçn,279,150,129,1,0,1,247,133,114,271,1,239,447,146,2,141
26,Concepcií_n de Buenos Aires,9,4,5,0,0,0,9,4,5,9,0,9,11,27,0,24
27,Cuautitlíçn de Garcí_a Barragíçn,150,80,70,1,1,0,101,55,46,150,1,101,279,159,2,145
28,Cuautla,0,0,0,0,0,0,0,0,0,0,0,0,0,10,0,9
29,Cuquí_o,23,14,9,0,0,0,4,3,1,23,0,4,53,56,0,48
30,Chapala,138,80,58,2,0,2,82,46,36,135,2,81,310,190,4,176
31,Chimaltitíçn,49,24,25,0,0,0,39,18,21,45,0,37,87,34,0,33
32,Chiquilistlíçn,8,5,3,0,0,0,7,4,3,7,0,7,21,13,0,13
33,Degollado,72,37,35,0,0,0,47,24,23,70,0,45,137,45,0,42
34,Ejutla,0,0,0,0,0,0,0,0,0,0,0,0,0,4,0,4
35,Encarnacií_n de Dí_az,86,42,44,0,0,0,9,6,3,84,0,9,165,74,0,67
36,Etzatlíçn,21,15,6,0,0,0,4,3,1,21,0,4,66,28,0,26
37,El Grullo,156,82,74,7,3,4,134,73,61,142,3,124,181,598,6,578
38,Guachinango,6,1,5,0,0,0,3,1,2,6,0,3,18,39,1,34
39,Guadalajara,5575,2783,2792,57,24,33,3398,1668,1730,5471,48,3369,9844,6603,102,6330
40,Hostotipaquillo,70,49,21,0,0,0,63,45,18,70,0,63,79,40,2,35
41,Huejí_car,16,9,7,0,0,0,14,7,7,14,0,12,31,11,0,10
42,Huejuquilla el Alto,531,254,277,47,20,27,464,224,240,494,38,439,631,400,38,344
43,La Huerta,67,32,35,1,0,1,52,24,28,67,1,52,135,79,0,71
44,Ixtlahuacíçn de los Membrillos,152,81,71,0,0,0,108,55,53,150,0,107,323,72,0,69
45,Ixtlahuacíçn del Rí_o,16,9,7,0,0,0,5,3,2,16,0,5,36,20,0,16
46,Jalostotitlíçn,67,43,24,0,0,0,26,19,7,67,0,26,198,58,0,50
47,Jamay,67,39,28,0,0,0,54,31,23,64,0,53,146,91,0,90
48,Jesí_s Marí_a,27,10,17,0,0,0,13,7,6,27,0,13,62,51,0,44
49,Jilotlíçn de los Dolores,11,6,5,0,0,0,10,5,5,10,0,9,28,32,0,26
50,Jocotepec,78,43,35,0,0,0,41,23,18,76,0,41,119,101,1,94
51,Juanacatlíçn,27,17,10,0,0,0,6,5,1,24,0,6,46,24,0,21
52,Juchitlíçn,9,4,5,0,0,0,8,3,5,9,0,8,18,17,0,15
53,Lagos de Moreno,217,123,94,0,0,0,61,35,26,210,0,61,534,240,0,218
54,El Limí_n,8,5,3,0,0,0,3,2,1,8,0,3,27,8,0,8
55,Magdalena,62,30,32,0,0,0,46,25,21,60,0,44,140,26,0,22
56,Santa Marí_a del Oro,2,2,0,0,0,0,1,1,0,2,0,1,2,14,0,10
57,La Manzanilla de la Paz,3,0,3,0,0,0,3,0,3,3,0,3,7,12,0,12
58,Mascota,15,13,2,0,0,0,7,6,1,15,0,7,34,29,0,28
59,Mazamitla,24,14,10,0,0,0,16,9,7,23,0,16,74,38,0,36
60,Mexticacíçn,9,6,3,0,0,0,4,4,0,9,0,4,23,11,0,10
61,Mezquitic,12540,6044,6496,4316,1557,2759,8072,4408,3664,11591,3540,7918,13930,7652,2548,4990
62,Mixtlíçn,2,2,0,0,0,0,1,1,0,2,0,1,0,8,0,5
63,Ocotlíçn,199,104,95,1,0,1,102,57,45,195,1,101,482,170,1,162
64,Ojuelos de Jalisco,32,22,10,0,0,0,10,6,4,31,0,10,87,35,0,29
65,Pihuamo,17,10,7,0,0,0,11,7,4,14,0,10,27,51,0,47
66,Poncitlíçn,64,33,31,0,0,0,9,7,2,61,0,9,124,38,0,31
67,Puerto Vallarta,2446,1304,1142,19,5,14,1834,987,847,2389,15,1801,5070,1967,30,1863
68,Villa Purificacií_n,14,8,6,0,0,0,7,5,2,14,0,7,35,97,20,75
69,Quitupan,8,3,5,0,0,0,2,2,0,7,0,2,16,49,0,41
70,El Salto,484,265,219,3,0,3,323,174,149,476,2,321,1252,321,0,305
71,San Cristí_bal de la Barranca,42,21,21,2,1,1,33,18,15,37,1,29,48,16,0,15
72,San Diego de Alejandrí_a,7,6,1,0,0,0,1,1,0,7,0,1,24,12,0,6
73,San Juan de los Lagos,119,72,47,0,0,0,55,36,19,117,0,55,215,108,0,103
74,San Juliíçn,21,12,9,0,0,0,8,6,2,21,0,8,37,59,0,52
75,San Marcos,1,1,0,0,0,0,0,0,0,1,0,0,4,4,0,3
76,San Martí_n de Bolaí±os,97,45,52,1,1,0,94,44,50,96,1,93,179,56,0,52
77,San Martí_n Hidalgo,37,23,14,0,0,0,25,15,10,37,0,25,64,47,0,42
78,San Miguel el Alto,109,67,42,1,0,1,32,22,10,103,1,31,195,59,1,51
79,Gí_mez Farí_as,5,3,2,0,0,0,1,0,1,5,0,1,7,24,0,23
80,San Sebastiíçn del Oeste,3,2,1,0,0,0,0,0,0,2,0,0,1,30,0,26
81,Santa Marí_a de los íngeles,2,0,2,0,0,0,2,0,2,2,0,2,0,12,0,10
82,Sayula,128,78,50,0,0,0,91,62,29,123,0,91,314,257,0,244
83,Tala,265,144,121,0,0,0,202,111,91,263,0,202,552,88,0,79
84,Talpa de Allende,23,15,8,0,0,0,8,6,2,23,0,8,63,27,0,25
85,Tamazula de Gordiano,99,57,42,1,1,0,53,32,21,99,1,53,197,331,2,307
86,Tapalpa,25,17,8,0,0,0,11,6,5,25,0,11,55,71,0,58
87,Tecalitlíçn,24,18,6,0,0,0,13,10,3,24,0,13,49,43,0,41
88,Tecolotlíçn,21,13,8,0,0,0,5,2,3,20,0,5,51,45,0,44
89,Techaluta de Montenegro,3,1,2,0,0,0,0,0,0,3,0,0,1,15,0,12
90,Tenamaxtlíçn,17,11,6,0,0,0,9,6,3,17,0,9,41,72,0,60
91,Teocaltiche,123,70,53,1,0,1,74,45,29,117,1,73,237,106,0,98
92,Teocuitatlíçn de Corona,16,10,6,0,0,0,5,5,0,16,0,5,41,26,0,26
93,Tepatitlíçn de Morelos,250,148,102,1,1,0,87,54,33,243,1,87,560,301,1,278
94,Tequila,75,46,29,0,0,0,19,14,5,75,0,19,190,76,0,71
95,Teuchitlíçn,8,6,2,0,0,0,5,4,1,8,0,5,25,18,0,14
96,Tizapíçn el Alto,36,23,13,0,0,0,17,12,5,35,0,17,86,95,0,83
97,Tlajomulco de Zí_í±iga,2082,1080,1002,13,5,8,1450,756,694,2035,6,1441,4280,464,2,426
98,Tlaquepaque,3250,1697,1553,30,8,22,2350,1243,1107,3175,26,2320,7339,2557,16,2401
99,Tolimíçn,26,20,6,0,0,0,11,10,1,26,0,11,36,14,0,10
100,Tomatlíçn,312,162,150,75,22,53,205,119,86,290,59,199,482,96,1,91
101,Tonalíç,1761,1042,719,15,6,9,1062,624,438,1719,14,1050,3389,1306,11,1217
102,Tonaya,9,6,3,0,0,0,6,4,2,9,0,6,28,12,0,9
103,Tonila,9,5,4,0,0,0,4,3,1,9,0,4,21,3,0,3
104,Totatiche,37,16,21,0,0,0,30,14,16,36,0,29,60,41,1,37
105,Tototlíçn,14,9,5,0,0,0,5,4,1,14,0,5,40,60,0,52
106,Tuxcacuesco,48,31,17,0,0,0,47,30,17,47,0,46,72,48,0,46
107,Tuxcueca,11,6,5,0,0,0,5,4,1,10,0,5,22,45,0,40
108,Tuxpan,189,105,84,3,2,1,108,62,46,187,2,108,302,158,0,150
109,Unií_n de San Antonio,26,16,10,0,0,0,7,5,2,25,0,7,56,33,1,31
110,Unií_n de Tula,14,10,4,0,0,0,7,5,2,13,0,7,41,53,0,53
111,Valle de Guadalupe,10,5,5,0,0,0,3,1,2,10,0,3,21,12,0,10
112,Valle de Juíçrez,14,10,4,0,0,0,7,4,3,14,0,7,43,29,0,27
113,San Gabriel,537,308,229,16,5,11,492,290,202,524,16,479,694,31,0,24
114,Villa Corona,26,15,11,0,0,0,9,5,4,26,0,9,69,137,0,128
115,Villa Guerrero,289,147,142,68,33,35,203,106,97,260,47,197,341,176,22,148
